11111111
10000001
101EC101
101PP011
11111111