11111
10E01
1P001
1C101
11111
