111111
100001
1P0001
100C01
1C0E01
111111
