111111
100001
10P0C1
1E0001
111111