1111111111
10E0PC1001
1C10000001
1000000C01
1000000001
10C0000C01
1000000001
1000000001
1CCC000111
1000000001
1C00000001
1111111111
