11111111111
100E000CC01
101001C0001
1010P010001
11111111111