1111111111
10E0PC1001
1C10000001
1111111111
