11111111
100E0001
111C1111
111C0111
100P1111
11111111