111111111
1CCCECCC1
11C1111P1
1CCCCCCC1
111111111