111111111111111111111
1EC000000000000C00011
110001010010000010101
101001001010101000101
1P0000001C10C00000001
111111111111111111111