111111111111111111111
100E00000000000C00011
111001010010000010101
111001001010101000101
1P0000001C10C00000001
111111111111111111111