111111111
10C0E00C1
110011111
100PP0001
111111111